1111111111111111111111111111111111111111111111111111111111111
1000000000001O10000000000000000000001000000000000000000000001
1000000000000000000000000000000000000000000000000000000000001
1000000000000000000000000000000100000000000000000000000000001
1000000000000000000000000000000000000000000000000000000000001
10e0000000000000000000000000000000001000000000000000000000001
1000000000000000000000000000000000000000000000000000000000001
1000000000000000000000000000000000000000000000000000000000001
1O00000000000000000001111000000000000000000000000000000000001
1000000000000000000000000000000000000000000000000000000000001
1000000000000000000000000000000000000000000000000000000000001
1000000000000000000000000000000000000000000000000000000000001
1O00000000000000000000000000000000000000000000000000000000001
1000000000000000000000000000000000000000000000000000000000001
1000000000000000000000000000000000000000000000000000000000001
1000000000000000000000000000000000000000000000000000000000001
1000000000000000000000000000000000000000000000000000000000001
1100000000000000000000000000000000000000000000000000000000001
1O001O0100000000000000000000000000000000000000000000000000001
1111111111111111111111111111111111111111111111111111111111111
