1111111111111111111111111111
10001101100000000000000000011
11100010100000000001110100011
100010000001O0000010010010011111111111111111111111111111111111111111111111111111
10010100N00000000000000000O00000000000000000000000000000000000000000000000000001
100001000000000000000000000000000O0000000000000000010000000000000000000000000001
10010100000000000000000000010000000000000000000000000000000000000000000000000001
100001100000000000000O0000011111111111111111111111111111111111111111111111111111
1000010000000000000000000001
1000000000000000000000100111
10000100000100000000010001
10000010001 1000000000000111
1111111111  1111111111111111