1111111111111111111111111111
10N01101100000000000000000011
11100010100000000000110100011
1000100N01000000001001001001
1001010000000000000100100001
1000001000000000001010000001
1001010000000000000100100001
1000001000000000000010000001
1000010000000000000000000001
1000000000000000000000100111
1000010000010000000001001
10000010001 1000000000000111
1111111111  1111111111111111