NO ./assets/textures/brick.png
EA ./assets/textures/red_wall.png
SO ./assets/textures/greyBrick.png
WE ./assets/textures/redBrick.png
C 205,111,221
F 0,1,2

1111111111111111111111111111
10001101100000000000000000011
1110001100000000101110100011
10001000000100000O10010010011111111111111111111111111111111111111111111111111111
10010100S00000000100000000000000000000000000000000000000000000000000000000000001
10000100000000000000000000000000000000000000000000010000000000000000000000000001
10010100000000000000000000010000000000000000000000000000000000000000000000000001
10000110E0O0000000000O0000011111111111111111111111111111111111111111111111111111
1000010000000000000000000001
1000000000000000000000100111
10000100000100000000010001
10000010001 1000000000000111
1111111111  1111111111111111