1111111111111111111111111111
10001101100000000000000000011
11100010100000000001110100011
10001000000100000010010010011111111111111111111111111111111111111111111111111111
10010100N000000000000O0000000000000000000000000000000000000000000000000000000001
10000100000000000000000000000000000000000000000000010000000000000000000000000001
10010100000000000000000000010000000000000000000000000000000000000000000000000001
10000110000000000000000000011111111111111111111111111111111111111111111111111111
1000010000000000000000000O01
1000000000000000000000100111
1000010O000100000000010001
10000010001 1000000000000111
1111111111  1111111111111111