
111111
11D111
1000D1
10N011
100011
100011
100011
100011
111111