NO ./assets/textures/brick.png
EA ./assets/textures/red_wall.png
SO ./assets/textures/greyBrick.png
WE ./assets/textures/redBrick.png
C 205,111,221
F 0,1,2

1111111111111111111111111111111111111111111111111111111111111
1000000000001D10000000000000000000001000000000000000000000001
1000000000000000000000000000000000000000000000000000000000001
1000000000000000000000000000000100000000000000000000000000001
1000000000000000000000000000000000000000000000000000000000001
1000000000000000000000000000000000001000000000000000000000001
1000000000000000000000000000000000000000000000000000000000001
1100000000000000000000000000000000000000000000000000000000001
1D00000000000000000001111000000000000000000000000000000000001
1100000000000000000000000000000000000000000000000000000000001
1000000000000000000000000000000000000000000000000000000000001
1100000000000000000000000000000000000000000000000000000000001
1D00000000000000000000000000000000000000000000000000000000001
1100000000000000000000000000000000000000000000000000000000001
1000000000000000000000000000000000000000000000000000000000001
1000000000000000000000000000000000000000000000000000000000001
1000000000000000000000000000000000000000000000000000000000001
1100000000000000000000000000000000000000000000000000000000001
1D001D0100000000000000000000000000000000000000000000000000001
1111111111111111111111111111111111111111111111111111111111111
