1111111111111111111111111111111111111111111111111111111111111
100000000001D100000000000000100000000000000000000000000000001
1000000000000000000000000000D00000000000000000000000000000001
1000000000000000000000000000100000000000000000000000000000001
100000000000E000000000000000D00000000000000000000000000000001
1000000000000000000000000000100000000000000000000000000000001
1000000000000000000000000000D00000000000000000000000000000001
1000000000000000000000000000100000000000000000000000000000001
1000000000000000000000000000D00000000000000000000000000000001
1000000000000000000000000000100000000000000000000000000000001
1000000000000000000000000000D00000000000000000000000000000001
1111111111111111111111111111111111111111111111111111111111111