1111111111111111111111111111
1001101000000000000000000011
1000010000000000000110100001
1000000N00000000001001001001
1000000000000000000100100001
1000001011110000000000001
111111111  1111111111111111111