NO ./assets/textures/brick.png
EA ./assets/textures/red_wall.png
SO ./assets/textures/greyBrick.png
WE ./assets/textures/redBrick.png
C 205,111,221
F 0,1,2

111111
1010101
1000N11
1101001
1001001
1001001
1101001
11D1001
1001001
1101001
111111