NO ./assets/textures/brick.png
EA ./assets/textures/red_wall.png
SO ./assets/textures/greyBrick.png
WE ./assets/textures/redBrick.png
C 205,131,221
F 0,1,2

111111111111111111111111111
10000000000000000000000011
100000000000111111111111
100000000001
100E000100011
100000000001
100000000001111111111111111
100000000000000000000000001
100000000000000000000000001
100000000000000000000000001
100000000000000000000000001
10000000000100000000000001
10000000001 10000000000001
10000000000100000000000001
100000000000000000000000001
100000000000000000000000001
111111111111111111111111111
11111111111