NO ../assets/textures/hitler.png
EA ../assets/textures/red_wall.png
SO ../assets/textures/ss.png
WE ../assets/textures/brick.png
C 205,111,221
F 0,1,2


1111111111111111111111111111
10001101100000000000000000011
11100010100000000001110100011
10001000000100000010010010011111111111111111111111111111111111111111111111111111
10010100000000000000000000000000000000000000000000000000000000000000000000000001
10000100S00000000000000000000000000000000000000000010000000000000000000000000001
10010100000000000001001000010000000000000000000000000000000000000000000000000001
10000110000000000000100000011111111111111111111111111111111111111111111111111111
1000010000000000000000000001
1000000000000000000000100111
1000010000010000000001001
10000010001 1000000000000111
1111111111  1111111111111111