NO ../assets/textures/hitler.png
EA ../assets/textures/red_wall.png
SO ../assets/textures/ss.png
WE ../assets/textures/brick.png
C 205,111,221
F 0,1,2


111111
110111
100001
10N011
100011
111111
