NO ./assets/textures/brick.png
EA ./assets/textures/red_wall.png
SO ./assets/textures/greyBrick.png
WE ./assets/textures/redBrick.png
C 205,171,221
F 0,1,2


1111111
1000001
1000001
1000001
111N111
1110111
1111111