1111111111111111111111111111
1001101000000000000000000011
1000010000000000000110100001
1000100N00000000001001001001
1001010000000000000100100001
1000001000000000001010000001
1001010000000000000100100001
1000001000000000000010000001
1000010000000000000001000001
1000000000000000000000100001
1000010000000000000001000001
1000001000000000000000000001
1111111111111111111111111111