NO .png
SO 1.png
WE 3.png
EA 2.png
F 20,10,255
C 0,0,0

start
11111111

11111111
end


1