
NO 1.png
SO 1.png
WE 2.png
EA 3.png
F 0,1,2
C 225,111,22

 1111111111111
100000000000001
 100000N000001
  10000000001
   100000001
    1000001
     10001
      101
       1