NO .png
SO 1.png
WE 2.png
EA 3.png
C 205,111,221
F 0,1,2


11111111
1000N01
1111111
